ssssssss.....
sh0000ps.....
s000000s.....
s000000s.....
s00000bs.....
s0000bbs.....
s000bbbs.....
sssssbbbsssss
.....sbbb00ps
.....sbb0000s
.....sb00000s
.....s000000s
.....s000000s
.....s00000ds
.....ssssssss