sssssssss
sh00000ps
s0000000s
s0000000s
s0000000s
s0000000s
s0000000s
s0000000s
sp00000ds
sssssssss